00 00 00 00 00 00 00 00 00 00 00 00 00 00 00 00 00 00 00 00 00 00 00 00 00
00 00 00 00 00 00 00 00 00 00 00 00 00 00 00 00 00 00 00 00 00 00 00 00 00
00 00 00 00 00 00 00 00 00 00 00 00 00 00 00 00 00 00 00 00 00 00 00 00 00
00 00 00 00 00 00 00 00 00 00 00 00 00 00 00 00 00 00 00 00 00 00 00 00 00
00 00 00 00 00 00 00 00 00 00 00 00 00 00 00 00 00 00 00 00 00 00 00 00 00
00 00 00 00 00 00 00 00 00 00 00 00 00 00 00 00 00 00 00 00 00 00 00 00 00
00 00 00 00 00 00 00 00 00 00 00 00 00 00 00 00 00 00 00 00 00 00 00 00 00
00 00 00 00 00 00 00 00 00 00 00 00 00 00 00 00 00 00 00 00 00 00 00 00 00
00 00 00 00 00 00 00 00 00 00 00 00 00 00 00 00 00 00 00 00 00 00 00 00 00
00 00 00 00 00 00 00 00 00 00 00 00 00 00 00 00 00 00 00 00 00 00 00 00 00
00 00 00 00 00 00 00 00 00 00 00 00 00 00 00 00 00 00 00 00

00 00 00 00 00 00 00 00 00 00 00 00 00 00 00 00 00 00 00 00 00 00 00 00 00
00 00 00 00 00 00 00 00 00 00 00 00 00 00 00 00 00 19 17 00 00 00 00 00 00
00 00 00 00 00 00 00 00 59 56 00 52 56 00 00 00 00 00 00 00 00 00 00 00 19
17 00 00 00 00 00 00 59 49 56 00 00 00 00 00 00 00 00 52 56 00 00 00 00 00
00 00 00 00 00 00 59 56 00 00 00 00 19 21 13 27 24 27 00 00 00 00 00 00 00
00 00 00 00 00 00 00 00 00 00 00 24 21 27 00 00 00 00 00 00 00 00 00 00 00
00 00 59 49 56 00 00 00 00 00 00 00 00 00 00 00 00 00 00 00 00 00 59 56 00
00 00 00 00 00 00 00 00 00 00 00 24 27 00 00 00 00 00 00 00 00 00 00 00 00
00 00 00 00 00 00 00 59 56 59 54 00 00 00 00 00 00 00 59 56 00 00 00 00 00
00 00 00 00 00 00 00 00 00 00 00 59 56 00 00 00 00 00 00 00 00 00 59 56 00
00 00 00 00 00 00 00 00 00 00 00 00 00 00 00 00 00 00 00 00

00 00 00 00 67 00 00 00 00 00 24 07 13 17 15 00 00 67 00 00 00 00 00 00 67
39 43 49 41 00 67 00 00 67 62 63 67 00 67 00 09 07 20 28 27 00 00 00 15 00
00 19 11 67 00 00 00 39 60 57 49 53 57 41 00 00 67 00 00 00 00 00 00 24 20
28 17 00 00 00 00 39 60 50 57 54 00 00 00 00 52 43 49 53 57 41 00 00 00 00
67 62 63 67 00 39 60 57 49 49 41 09 20 22 29 28 25 28 27 00 67 00 00 00 00
00 00 00 00 67 00 00 19 11 09 07 25 22 28 05 11 00 15 00 00 19 11 00 67 39
43 49 60 50 57 54 00 00 00 00 00 00 52 56 59 54 00 39 35 31 54 52 60 57 54
00 00 00 00 52 49 43 41 00 00 19 25 28 11 09 17 00 00 19 17 15 00 00 09 11
67 00 62 63 00 39 35 60 57 60 55 41 00 00 00 00 59 49 60 57 56 00 52 41 00
00 00 00 19 17 15 00 00 09 11 52 60 57 35 31 41 39 54 00 00 00 39 60 57 41
00 67 00 00 00 00 00 00 00 00 00 00 00 00 00 00 00 00 00 00

00 00 00 67 68 00 15 66 24 21 25 08 02 18 16 11 66 68 67 00 67 39 43 41 68
40 50 38 42 67 68 66 67 68 64 65 68 67 68 66 10 08 26 23 28 21 13 14 16 05
07 20 12 68 67 00 66 40 61 44 50 61 58 42 66 67 68 66 00 00 00 00 19 25 29
26 18 11 00 00 00 40 61 51 58 55 46 49 46 33 53 38 44 61 58 42 66 67 00 00
68 64 65 68 67 40 61 58 44 38 42 10 02 04 26 29 26 29 28 17 68 00 00 00 00
00 00 00 67 68 09 13 20 12 10 08 26 23 29 06 12 19 16 14 13 20 12 66 68 40
44 44 61 51 58 55 43 46 54 67 66 52 53 57 60 55 41 40 36 32 55 53 61 58 55
49 43 54 59 53 38 44 42 00 09 20 26 29 12 10 18 13 14 20 18 16 14 11 10 12
68 66 64 65 00 40 36 61 58 61 32 42 52 49 54 59 60 50 61 58 57 49 53 42 00
19 21 14 20 18 16 14 11 10 12 53 61 58 36 32 42 40 55 56 39 56 40 61 58 42
66 68 67 00 00 00 00 00 00 00 00 00 00 00 00 00 00 00 00 00

00 00 00 00 00 00 00 00 00 00 00 00 00 00 00 00 00 00 00 00 00 00 00 00 00
00 00 00 00 00 00 00 00 00 00 00 00 00 00 00 00 00 00 00 00 00 00 00 00 00
00 00 00 00 00 00 00 00 00 00 00 00 00 00 00 00 00 00 00 00 00 00 00 00 00
00 00 00 00 00 00 00 00 00 00 00 00 00 00 00 00 00 00 00 00 00 00 00 00 00
00 00 00 00 00 00 00 00 00 00 00 00 00 00 00 00 00 00 00 00 00 00 00 00 00
00 00 00 00 00 00 00 00 00 00 00 00 00 00 00 00 00 00 00 00 00 00 00 00 00
00 00 00 00 00 00 00 00 00 00 00 00 00 00 00 00 00 00 00 00 00 00 00 00 00
00 00 00 00 00 00 00 00 00 00 00 00 00 00 00 00 00 00 00 00 00 00 00 00 00
00 00 00 00 00 00 00 00 00 00 00 00 00 00 00 00 00 00 00 00 00 00 00 00 00
00 00 00 00 00 00 00 00 00 00 00 00 00 00 00 00 00 00 00 00 00 00 00 00 00
00 00 00 00 00 00 00 00 00 00 00 00 00 00 00 00 00 00 00 00

