00 00 00 00 00 00 00 00 00 70 00 00 00 00 00 00 70 00 00 00 00 00 00 00 00
00 00 75 00 00 00 00 00 00 00 00 70 00 00 00 00 00 00 00 00 00 75 00 70 75
00 00 00 71 00 75 00 00 00 00 00 00 00 00 00 70 00 75 70 70 00 75 70 00 00
00 00 00 75 70 75 00 00 00 00 00 00 75 00 00 00 00 00 00 00 00 70 00 00 00
00 75 00 00 00 00 00 00 00 00 75 00 00 00 00 00 00 00 00 00 00 71 75 00 00
00 00 00 00 00 00 00 70 00 75 00 00 00 00 00 00 75 00 75 00 00 00 00 00 00
00 00 00 00 00 00 00 00 00 00 00 75 00 00 00 00 00 00 00 00 75 00 00 00 00
70 00 00 70 00 00 00 00 75 00 00 00 00 00 00 00 00 71 75 00 00 00 00 00 00
00 00 75 00 00 70 00 00 00 00 00 00 00 75 00 00 00 00 00 00 00 00 70 75 00
00 75 00 00 00 00 00 75 00 00 00 00 00 00 00 00 75 00 00 75 00 00 00 00 00
00 00 77 00 00 00 00 00 00 00 00 00 00 00 00 00 00 00 00 00

00 00 00 00 72 00 72 00 00 00 00 76 72 00 00 00 00 00 00 00 00 00 70 00 00
00 00 00 00 00 70 00 00 00 00 00 00 00 00 00 00 00 00 30 71 00 00 72 00 00
00 00 00 00 00 00 00 00 00 00 70 71 00 00 00 00 00 00 00 75 70 75 00 00 00
69 00 71 00 75 00 00 00 00 72 00 72 00 00 00 72 00 00 30 00 00 00 00 75 00
00 00 72 00 70 00 71 00 00 00 00 00 00 00 00 72 00 00 00 00 72 00 00 00 00
00 00 00 00 72 00 00 00 00 00 00 30 00 00 00 00 00 00 00 00 00 00 75 00 00
00 00 30 00 00 00 00 00 70 00 00 00 00 00 00 00 70 00 76 00 00 00 00 75 00
00 00 00 00 00 00 00 00 00 00 00 00 00 00 75 00 00 00 00 00 70 00 00 75 00
00 00 00 00 00 00 00 00 00 00 30 00 00 70 00 00 00 00 00 00 00 00 00 00 00
00 00 00 70 00 00 00 00 00 00 00 00 00 00 00 00 00 00 00 70 00 00 00 00 00
00 00 00 00 00 00 00 00 00 00 00 00 00 00 00 00 00 00 00 00

00 75 00 00 00 75 00 00 72 00 75 72 00 30 00 00 00 00 00 75 00 00 00 00 00
30 00 00 00 00 00 00 70 69 72 72 00 00 00 73 00 69 00 00 30 00 00 00 00 00
00 30 00 00 75 00 72 00 00 71 00 00 00 30 70 00 00 72 00 00 75 00 72 00 00
00 00 00 00 00 00 74 00 00 00 00 70 00 75 00 30 69 00 72 00 00 00 00 00 00
00 73 72 00 00 69 00 00 71 71 00 30 00 00 00 00 00 72 69 00 00 00 73 00 75
00 75 00 00 00 74 00 00 00 69 71 00 00 00 00 00 00 00 00 00 71 00 00 00 69
00 00 00 00 00 00 00 72 75 00 00 00 00 00 30 69 00 75 00 00 69 30 00 00 69
00 00 71 00 75 30 00 69 00 00 00 72 30 00 00 00 76 72 00 30 00 71 00 00 72
00 00 00 00 75 00 69 00 00 00 00 30 00 00 71 00 30 00 00 00 00 00 00 69 71
72 00 00 00 00 00 72 71 00 30 00 00 00 00 00 30 00 69 00 00 00 30 00 00 00
00 00 75 00 00 00 00 00 00 00 00 00 00 00 00 00 00 00 00 00

75 00 00 75 00 00 00 75 00 00 00 00 00 00 00 00 72 00 00 72 00 00 69 00 00
00 00 00 00 00 00 00 00 00 72 72 00 00 00 00 00 00 00 00 00 00 00 00 69 00
00 00 00 00 00 73 00 00 00 00 71 00 00 00 00 00 00 00 70 00 72 00 00 00 00
00 00 00 75 00 00 00 00 00 00 00 76 00 30 30 30 72 00 00 00 00 00 00 71 66
00 72 72 00 00 00 00 74 00 00 00 73 00 00 00 00 00 00 00 00 00 75 00 75 00
75 00 00 75 00 71 69 72 00 00 00 00 00 00 74 00 00 69 73 30 74 00 00 72 00
00 00 00 00 00 71 73 00 69 74 00 00 00 71 72 00 69 00 00 74 00 00 72 71 00
00 00 00 00 00 00 00 00 72 69 71 00 00 00 00 74 69 00 30 30 00 00 30 73 00
00 73 00 00 00 71 72 00 74 00 00 00 00 00 69 72 00 00 00 74 30 73 00 00 00
00 72 00 30 30 00 73 71 74 00 00 00 72 00 00 00 00 00 72 00 71 72 00 00 00
00 00 00 00 00 00 00 00 00 00 00 00 00 00 00 00 00 00 00 00

00 00 00 00 00 00 00 00 00 00 00 00 00 00 00 00 00 00 00 00 00 00 00 00 00
00 00 00 00 00 00 00 00 00 00 00 00 00 00 00 00 00 00 00 00 00 00 00 00 00
00 00 00 00 00 00 00 00 00 00 00 00 00 00 00 00 00 00 00 00 00 00 00 00 00
00 00 00 00 00 00 00 00 00 00 00 00 00 00 00 30 30 00 00 00 00 00 00 00 00
00 00 00 00 00 00 00 00 00 00 00 00 00 00 00 00 00 00 00 00 00 00 00 30 00
00 00 00 00 00 00 00 00 00 00 00 00 00 00 00 00 00 00 00 00 00 00 00 00 00
00 00 00 00 00 00 00 00 00 00 00 00 00 00 00 00 00 00 00 00 00 00 00 00 00
00 00 00 00 00 00 00 00 00 00 00 00 00 00 00 00 00 00 00 00 00 00 00 00 00
00 00 00 00 00 00 00 00 00 00 00 00 00 00 00 00 00 00 00 00 00 00 00 00 00
00 00 00 00 00 00 00 00 00 00 00 00 00 00 00 00 00 00 00 00 00 00 00 00 00
00 00 00 00 00 00 00 00 00 00 00 00 00 00 00 00 00 00 00 00
